abhkbh_u.htm 	Abhidharmakosabhasya (karikas of chapters 1-8)
aksobhmu.htm 	Aksobhyamanjuvajra
astspr_u.htm 	Astasahasrika Prajnaparamita
bsu004_u.htm 	Sitatapatra
bus004_u.htm 	Sitatapatra
dhvany_u.htm 	Anandavardhana: Dhvanyaloka
ksakunau.htm 	Kalidasa: Abhijnanasakuntalam
ksakunpu.htm 	Kalidasa: Abhijnanasakuntalam
kums1-5u.htm 	Kalidasa: Kumarasambhava
lip_1__u.htm 	Linga-Purana 1,2 - 108
mbh1-18u.htm 	% Mahabharata, Parvans 1 - 18
mpratsvu.htm 	Mahapratisaravidya-Dharani
mrgt3miu.htm 	Mrgendragama, Caryapada: Pada index
naray_au.htm 	Narayaniya (MBh 12,321-339): analytic text
nitrrk1u.htm 	Nityanathasiddha: Rasaratnakara, Khanda 1
pm047__u.htm 	naanmaNikkaTikai of viLampinaakanaar
pm074__u.htm 	paththirakiriyar's meynjanap pulampal (Siddar's series)
pm076__u.htm 	siththar patalkaL Series - i
pm083__u.htm 	cittar patalkaL Series -part ii (paTTinattar paTalkaL)
pm088__u.htm 	maraNattuL vazvOm
pm092__u.htm 	tiruisappa, tiruppallaNTu (9th thirumurai)
pm129__u.htm 	11th tirumuRai pAsurams
pm146b_u.htm 	Tirumurai VIm  part IV (verses 5064 -5818)
pmbh_1su.htm 	Patanjali: Vyakaranamahabhasya, Adhyaya 1
pmbh_1uu.htm 	Patanjali: Vyakaranamahabhasya, Adhyaya 1
pmbh_2su.htm 	Patanjali: Vyakaranamahabhasya, 2
pmbh_2uu.htm 	Patanjali: Vyakaranamahabhasya, 2
pmbh_3su.htm 	Patanjali: Vyakaranamahabhasya, 3
pmbh_3uu.htm 	Patanjali: Vyakaranamahabhasya, 3
pmbh_4su.htm 	Patanjali: Vyakaranamahabhasya, 4
pmbh_4uu.htm 	Patanjali: Vyakaranamahabhasya, 4
pmbh_5su.htm 	Patanjali: Vyakaranamahabhasya, 5
pmbh_5uu.htm 	Patanjali: Vyakaranamahabhasya, 5
pmbh_6su.htm 	Patanjali: Vyakaranamahabhasya, 6
pmbh_6uu.htm 	Patanjali: Vyakaranamahabhasya, 6
pmbh_7su.htm 	Patanjali: Vyakaranamahabhasya, 7
pmbh_7uu.htm 	Patanjali: Vyakaranamahabhasya, 7
pmbh_8su.htm 	Patanjali: Vyakaranamahabhasya, 8
pmbh_8uu.htm 	Patanjali: Vyakaranamahabhasya, 8
prabhasu.htm 	Prabhasajataka
ram_02su.htm 	Ramayana: 2. Ayodhyakanda
ram_1-7u.htm 	Valmiki: Ramayana 1-7
rasadhau.htm 	Rasadhyaya (with Tika), verses 1-302
rasadhpu.htm 	Rasadhyaya (with Tika), verses 1-302
rasr1-5u.htm 	Vagbhata: Rasaratnasamuccaya
sanbhe1u.htm 	Sanghabhedavastu
sanbhe2u.htm 	Sanghabhedavastu
sardulau.htm 	Sardulakarnavadana
vidsrkgu.htm 	Vidyakara: Subhasitaratnakosa
vidsrkxu.htm 	Vidyakara: Subhasitaratnakosa
